sr_no,0,1,target,prediction,Excel_predict,sum
1,0,120,1,1,1,120
2,67,0,0,0,0,67
3,120,0,0,0,0,120
4,119,0,0,0,0,119
5,115,5,0,0,0,120
6,91,0,0,0,0,91
7,0,117,1,1,1,117
8,0,71,1,1,1,71
9,120,0,0,0,0,120
10,114,0,0,0,0,114
11,120,0,0,0,0,120
12,107,12,0,0,0,119
13,118,1,0,0,0,119
14,1,110,1,1,1,111
15,119,1,0,0,0,120
16,1,118,1,1,1,119
17,120,0,0,0,0,120
18,0,113,1,1,1,113
19,119,1,0,0,0,120
20,0,115,1,1,1,115
21,106,0,0,0,0,106
22,1,75,1,1,1,76
23,120,0,0,0,0,120
24,117,3,0,0,0,120
25,4,105,1,1,1,109
26,120,0,0,0,0,120
27,0,105,1,1,1,105
28,0,120,1,1,1,120
29,0,105,1,1,1,105
30,0,73,1,1,1,73
31,106,3,0,0,0,109
32,92,1,0,0,0,93
33,120,0,0,0,0,120
34,0,120,1,1,1,120
35,0,120,1,1,1,120
36,5,14,1,1,1,19
37,1,105,1,1,1,106
38,105,5,0,0,0,110
39,0,120,1,1,1,120
40,118,0,0,0,0,118
41,120,0,0,0,0,120
42,111,0,0,0,0,111
43,99,8,0,0,0,107
44,0,120,1,1,1,120
45,105,0,0,0,0,105
46,93,0,0,0,0,93
47,114,0,0,0,0,114
48,120,0,0,0,0,120
49,0,99,1,1,1,99
50,119,0,0,0,0,119
51,105,0,0,0,0,105
52,106,0,0,0,0,106
53,120,0,0,0,0,120
54,1,35,1,1,1,36
55,120,0,0,0,0,120
56,118,0,0,0,0,118
57,1,103,1,1,1,104
58,1,117,1,1,1,118
59,120,0,0,0,0,120
60,120,0,0,0,0,120
61,7,102,1,1,1,109
62,103,0,0,0,0,103
63,0,105,1,1,1,105
64,0,120,1,1,1,120
65,0,119,1,1,1,119
66,0,113,1,1,1,113
67,0,120,1,1,1,120
68,120,0,0,0,0,120
69,114,2,0,0,0,116
70,0,94,1,1,1,94
71,2,118,1,1,1,120
72,65,3,0,0,0,68
73,119,0,0,0,0,119
74,0,90,1,1,1,90
75,118,0,0,0,0,118
76,0,114,1,1,1,114
77,120,0,0,0,0,120
78,120,0,0,0,0,120
79,1,114,1,1,1,115
80,7,98,1,1,1,105
81,120,0,0,0,0,120
82,116,2,0,0,0,118
83,107,0,0,0,0,107
84,0,98,1,1,1,98
85,0,90,1,1,1,90
86,120,0,0,0,0,120
87,0,120,1,1,1,120
88,104,3,0,0,0,107
89,0,119,1,1,1,119
90,1,119,1,1,1,120
91,0,113,1,1,1,113
92,114,6,0,0,0,120
93,0,106,1,1,1,106
94,0,108,1,1,1,108
95,0,104,1,1,1,104
96,0,120,1,1,1,120
97,0,17,1,1,1,17
98,101,1,0,0,0,102
99,116,0,0,0,0,116
100,0,120,1,1,1,120
101,119,0,0,0,0,119
102,0,120,1,1,1,120
103,120,0,0,0,0,120
104,1,119,1,1,1,120
105,0,112,1,1,1,112
106,118,0,0,0,0,118
107,6,98,1,1,1,104
108,114,0,0,0,0,114
109,0,120,1,1,1,120
110,110,0,0,0,0,110
111,0,120,1,1,1,120
112,5,114,1,1,1,119
113,0,105,1,1,1,105
114,120,0,0,0,0,120
115,120,0,0,0,0,120
116,2,114,1,1,1,116
117,1,119,1,1,1,120
118,0,120,1,1,1,120
119,1,102,1,1,1,103
120,120,0,0,0,0,120
121,1,88,1,1,1,89
122,119,0,0,0,0,119
123,118,2,0,0,0,120
124,120,0,0,0,0,120
125,0,120,1,1,1,120
126,116,3,0,0,0,119
127,0,105,1,1,1,105
128,56,6,0,0,0,62
129,0,106,1,1,1,106
130,78,1,0,0,0,79
131,0,120,1,1,1,120
132,0,120,1,1,1,120
133,120,0,0,0,0,120
134,120,0,0,0,0,120
135,108,0,0,0,0,108
136,64,0,0,0,0,64
137,120,0,0,0,0,120
138,118,0,0,0,0,118
139,113,4,0,0,0,117
140,78,0,0,0,0,78
141,0,103,1,1,1,103
142,83,1,0,0,0,84
143,0,120,1,1,1,120
144,0,75,1,1,1,75
145,4,86,1,1,1,90
146,0,120,1,1,1,120
147,4,61,1,1,1,65
148,120,0,0,0,0,120
149,1,105,1,1,1,106
150,118,2,0,0,0,120
151,113,0,0,0,0,113
152,0,112,1,1,1,112
153,120,0,0,0,0,120
154,5,84,1,1,1,89
155,112,0,0,0,0,112
156,0,104,1,1,1,104
157,0,120,1,1,1,120
158,2,85,1,1,1,87
159,0,120,1,1,1,120
160,0,120,1,1,1,120
161,120,0,0,0,0,120
162,1,105,1,1,1,106
163,1,108,1,1,1,109
164,0,68,1,1,1,68
165,101,0,0,0,0,101
166,120,0,0,0,0,120
167,107,0,0,0,0,107
168,0,120,1,1,1,120
169,2,109,1,1,1,111
170,0,120,1,1,1,120
171,0,105,1,1,1,105
172,4,16,1,1,1,20
173,120,0,0,0,0,120
174,1,90,1,1,1,91
175,4,104,1,1,1,108
176,110,0,0,0,0,110
177,120,0,0,0,0,120
178,113,1,0,0,0,114
179,120,0,0,0,0,120
180,119,0,0,0,0,119
181,0,120,1,1,1,120
182,120,0,0,0,0,120
183,104,6,0,0,0,110
184,0,97,1,1,1,97
185,0,105,1,1,1,105
186,0,120,1,1,1,120
187,0,111,1,1,1,111
188,103,3,0,0,0,106
189,47,1,0,0,0,48
190,0,90,1,1,1,90
191,0,120,1,1,1,120
192,0,113,1,1,1,113
193,0,120,1,1,1,120
194,1,90,1,1,1,91
195,118,2,0,0,0,120
196,2,86,1,1,1,88
197,0,90,1,1,1,90
198,119,0,0,0,0,119
199,119,0,0,0,0,119
200,0,119,1,1,1,119
201,0,66,1,1,1,66
202,0,116,1,1,1,116
204,0,102,1,1,1,102
205,114,0,0,0,0,114
206,118,0,0,0,0,118
207,80,0,0,0,0,80
208,110,2,0,0,0,112
209,117,1,0,0,0,118
210,82,5,0,0,0,87
211,112,6,0,0,0,118
212,64,4,0,0,0,68
213,0,103,1,1,1,103
214,0,120,1,1,1,120
215,120,0,0,0,0,120
216,0,119,1,1,1,119
217,0,120,1,1,1,120
218,0,120,1,1,1,120
219,1,105,1,1,1,106
220,3,117,1,1,1,120
221,118,2,0,0,0,120
222,119,1,0,0,0,120
223,4,97,1,1,1,101
224,0,105,1,1,1,105
225,103,17,0,0,0,120
226,0,110,1,1,1,110
227,1,119,1,1,1,120
228,0,76,1,1,1,76
229,119,1,0,0,0,120
230,0,120,1,1,1,120
231,119,0,0,0,0,119
232,0,88,1,1,1,88
233,0,91,1,1,1,91
234,120,0,0,0,0,120
235,120,0,0,0,0,120
236,118,0,0,0,0,118
237,100,0,0,0,0,100
238,0,119,1,1,1,119
239,115,4,0,0,0,119
240,0,118,1,1,1,118
241,117,3,0,0,0,120
242,2,118,1,1,1,120
243,83,0,0,0,0,83
244,118,1,0,0,0,119
245,117,3,0,0,0,120
246,1,116,1,1,1,117
247,109,0,0,0,0,109
248,120,0,0,0,0,120
249,120,0,0,0,0,120
250,120,0,0,0,0,120
251,0,85,1,1,1,85
252,68,0,0,0,0,68
253,120,0,0,0,0,120
254,4,16,1,1,1,20
255,1,88,1,1,1,89
256,2,118,1,1,1,120
257,6,96,1,1,1,102
258,75,5,0,0,0,80
259,0,120,1,1,1,120
260,0,120,1,1,1,120
261,119,0,0,0,0,119
262,2,118,1,1,1,120
263,78,11,0,0,0,89
264,101,2,0,0,0,103
265,120,0,0,0,0,120
266,105,0,0,0,0,105
267,0,120,1,1,1,120
268,1,105,1,1,1,106
269,0,113,1,1,1,113
270,118,1,0,0,0,119
271,0,89,1,1,1,89
272,0,117,1,1,1,117
273,0,120,1,1,1,120
274,5,114,1,1,1,119
275,43,0,0,0,0,43
276,0,120,1,1,1,120
277,120,0,0,0,0,120
278,119,1,0,0,0,120
279,1,119,1,1,1,120
280,0,120,1,1,1,120
281,112,0,0,0,0,112
282,0,114,1,1,1,114
283,0,120,1,1,1,120
284,0,113,1,1,1,113
285,116,4,0,0,0,120
286,117,0,0,0,0,117
287,2,111,1,1,1,113
288,120,0,0,0,0,120
289,120,0,0,0,0,120
290,0,120,1,1,1,120
291,96,1,0,0,0,97
292,118,0,0,0,0,118
293,0,120,1,1,1,120
294,120,0,0,0,0,120
295,107,0,0,0,0,107
296,1,104,1,1,1,105
297,83,0,0,0,0,83
298,0,98,1,1,1,98
299,4,116,1,1,1,120
300,0,120,1,1,1,120
301,113,7,0,0,0,120
302,119,1,0,0,0,120
303,0,104,1,1,1,104
304,1,104,1,1,1,105
305,120,0,0,0,0,120
306,87,22,0,0,0,109
307,105,0,0,0,0,105
308,97,0,0,0,0,97
309,119,1,0,0,0,120
310,5,96,1,1,1,101
311,0,120,1,1,1,120
312,118,0,0,0,0,118
313,2,118,1,1,1,120
314,120,0,0,0,0,120
315,1,119,1,1,1,120
317,97,0,0,0,0,97
318,120,0,0,0,0,120
319,0,120,1,1,1,120
320,105,0,0,0,0,105
321,0,119,1,1,1,119
322,1,90,1,1,1,91
323,120,0,0,0,0,120
324,100,0,0,0,0,100
325,120,0,0,0,0,120
326,0,116,1,1,1,116
327,116,1,0,0,0,117
328,5,85,1,1,1,90
329,113,0,0,0,0,113
330,99,3,0,0,0,102
331,3,116,1,1,1,119
332,114,6,0,0,0,120
333,0,120,1,1,1,120
334,119,0,0,0,0,119
335,51,0,0,0,0,51
336,108,2,0,0,0,110
337,110,10,0,0,0,120
338,120,0,0,0,0,120
339,119,0,0,0,0,119
340,95,4,0,0,0,99
341,120,0,0,0,0,120
342,0,105,1,1,1,105
343,120,0,0,0,0,120
344,111,9,0,0,0,120
345,1,105,1,1,1,106
346,119,0,0,0,0,119
347,95,0,0,0,0,95
348,120,0,0,0,0,120
349,0,120,1,1,1,120
350,1,105,1,1,1,106
351,120,0,0,0,0,120
352,103,7,0,0,0,110
353,120,0,0,0,0,120
354,0,116,1,1,1,116
355,0,120,1,1,1,120
356,120,0,0,0,0,120
357,4,105,1,1,1,109
358,1,119,1,1,1,120
359,3,97,1,1,1,100
360,74,0,0,0,0,74
361,0,102,1,1,1,102
362,0,120,1,1,1,120
363,119,0,0,0,0,119
364,1,105,1,1,1,106
365,120,0,0,0,0,120
366,104,0,0,0,0,104
367,120,0,0,0,0,120
368,119,0,0,0,0,119
369,105,0,0,0,0,105
370,119,0,0,0,0,119
371,27,0,0,0,0,27
372,6,112,1,1,1,118
373,0,69,1,1,1,69
374,4,92,1,1,1,96
375,2,118,1,1,1,120
376,0,91,1,1,1,91
377,120,0,0,0,0,120
378,0,113,1,1,1,113
379,113,1,0,0,0,114
380,0,87,1,1,1,87
381,0,111,1,1,1,111
382,0,120,1,1,1,120
383,1,94,1,1,1,95
384,119,0,0,0,0,119
385,0,105,1,1,1,105
386,2,100,1,1,1,102
387,5,99,1,1,1,104
388,0,120,1,1,1,120
389,120,0,0,0,0,120
390,1,103,1,1,1,104
391,0,120,1,1,1,120
392,120,0,0,0,0,120
393,1,105,1,1,1,106
394,105,0,0,0,0,105
395,0,120,1,1,1,120
396,120,0,0,0,0,120
397,120,0,0,0,0,120
398,0,94,1,1,1,94
399,118,0,0,0,0,118
400,109,0,0,0,0,109
401,0,116,1,1,1,116
402,1,115,1,1,1,116
403,3,97,1,1,1,100
404,55,1,0,0,0,56
405,120,0,0,0,0,120
406,0,112,1,1,1,112
407,117,3,0,0,0,120
408,2,99,1,1,1,101
409,112,0,0,0,0,112
410,109,0,0,0,0,109
411,1,119,1,1,1,120
412,120,0,0,0,0,120
413,0,120,1,1,1,120
414,111,0,0,0,0,111
415,0,119,1,1,1,119
416,118,1,0,0,0,119
417,62,0,0,0,0,62
418,104,0,0,0,0,104
419,110,0,0,0,0,110
420,0,120,1,1,1,120
421,98,2,0,0,0,100
422,0,119,1,1,1,119
423,104,15,0,0,0,119
424,80,4,0,0,0,84
425,118,2,0,0,0,120
426,0,119,1,1,1,119
427,0,81,1,1,1,81
428,0,120,1,1,1,120
429,7,102,1,1,1,109
430,120,0,0,0,0,120
431,1,119,1,1,1,120
432,1,119,1,1,1,120
433,0,117,1,1,1,117
434,0,107,1,1,1,107
435,0,76,1,1,1,76
436,106,0,0,0,0,106
437,120,0,0,0,0,120
438,119,1,0,0,0,120
439,0,120,1,1,1,120
440,120,0,0,0,0,120
441,0,119,1,1,1,119
442,120,0,0,0,0,120
443,1,101,1,1,1,102
444,0,119,1,1,1,119
445,0,120,1,1,1,120
446,1,114,1,1,1,115
447,81,17,0,0,0,98
448,109,9,0,0,0,118
449,120,0,0,0,0,120
450,109,11,0,0,0,120
451,120,0,0,0,0,120
452,9,0,0,1,0,9
453,2,84,1,1,1,86
454,2,101,1,1,1,103
455,2,97,1,1,1,99
456,0,118,1,1,1,118
457,0,85,1,1,1,85
458,1,119,1,1,1,120
459,0,105,1,1,1,105
460,4,15,1,1,1,19
461,104,0,0,0,0,104
462,0,120,1,1,1,120
463,105,0,0,0,0,105
464,120,0,0,0,0,120
465,0,113,1,1,1,113
466,92,2,0,0,0,94
467,1,101,1,1,1,102
468,0,78,1,1,1,78
469,0,120,1,1,1,120
470,105,10,0,0,0,115
471,70,0,0,0,0,70
472,0,120,1,1,1,120
473,119,0,0,0,0,119
474,0,96,1,1,1,96
475,0,105,1,1,1,105
476,120,0,0,0,0,120
477,50,0,0,0,0,50
478,4,99,1,1,1,103
479,0,88,1,1,1,88
480,1,113,1,1,1,114
481,116,0,0,0,0,116
482,1,119,1,1,1,120
483,119,1,0,0,0,120
484,76,0,0,0,0,76
485,0,94,1,1,1,94
486,4,113,1,1,1,117
487,118,2,0,0,0,120
488,0,118,1,1,1,118
489,66,5,0,0,0,71
490,63,0,0,0,0,63
491,1,118,1,1,1,119
492,107,2,0,0,0,109
493,2,118,1,1,1,120
494,120,0,0,0,0,120
495,120,0,0,0,0,120
496,114,0,0,0,0,114
497,114,2,0,0,0,116
498,0,86,1,1,1,86
499,1,117,1,1,1,118
500,77,1,0,0,0,78
501,105,0,0,0,0,105
502,36,0,0,0,0,36
503,1,119,1,1,1,120
504,120,0,0,0,0,120
505,111,0,0,0,0,111
506,0,105,1,1,1,105
507,120,0,0,0,0,120
508,120,0,0,0,0,120
509,0,119,1,1,1,119
510,0,61,1,1,1,61
511,114,3,0,0,0,117
512,74,2,0,0,0,76
513,2,100,1,1,1,102
514,120,0,0,0,0,120
515,106,2,0,0,0,108
516,1,119,1,1,1,120
517,1,105,1,1,1,106
518,113,0,0,0,0,113
519,120,0,0,0,0,120
520,2,118,1,1,1,120
521,0,120,1,1,1,120
522,117,3,0,0,0,120
523,120,0,0,0,0,120
524,118,0,0,0,0,118
525,107,0,0,0,0,107
526,1,114,1,1,1,115
527,120,0,0,0,0,120
528,99,0,0,0,0,99
529,117,0,0,0,0,117
530,104,1,0,0,0,105
531,105,0,0,0,0,105
532,0,76,1,1,1,76
533,117,1,0,0,0,118
534,0,96,1,1,1,96
535,120,0,0,0,0,120
536,35,0,0,0,0,35
537,110,2,0,0,0,112
538,8,84,1,1,1,92
539,0,93,1,1,1,93
540,120,0,0,0,0,120
541,0,115,1,1,1,115
542,0,120,1,1,1,120
543,120,0,0,0,0,120
544,120,0,0,0,0,120
545,0,86,1,1,1,86
546,4,30,1,1,1,34
547,4,102,1,1,1,106
548,108,1,0,0,0,109
549,120,0,0,0,0,120
550,120,0,0,0,0,120
551,79,9,0,0,0,88
552,0,93,1,1,1,93
553,120,0,0,0,0,120
554,120,0,0,0,0,120
555,118,1,0,0,0,119
556,0,119,1,1,1,119
557,0,120,1,1,1,120
558,120,0,0,0,0,120
559,116,0,0,0,0,116
560,0,114,1,1,1,114
561,120,0,0,0,0,120
562,57,1,0,0,0,58
563,85,0,0,0,0,85
564,5,71,1,1,1,76
565,100,20,0,0,0,120
566,113,0,0,0,0,113
567,0,97,1,1,1,97
568,0,120,1,1,1,120
569,0,105,1,1,1,105
570,0,120,1,1,1,120
571,0,109,1,1,1,109
572,120,0,0,0,0,120
573,0,120,1,1,1,120
574,0,27,1,1,1,27
575,0,120,1,1,1,120
576,72,1,0,0,0,73
577,120,0,0,0,0,120
578,73,0,0,0,0,73
579,120,0,0,0,0,120
580,120,0,0,0,0,120
581,0,120,1,1,1,120
582,109,0,0,0,0,109
583,0,107,1,1,1,107
584,3,91,1,1,1,94
585,118,0,0,0,0,118
586,0,118,1,1,1,118
587,115,5,0,0,0,120
588,0,109,1,1,1,109
589,105,0,0,0,0,105
590,120,0,0,0,0,120
591,3,11,1,1,1,14
592,47,6,0,0,0,53
593,109,11,0,0,0,120
594,80,4,0,0,0,84
595,0,120,1,1,1,120
596,1,119,1,1,1,120
597,89,0,0,0,0,89
598,0,120,1,1,1,120
599,92,0,0,0,0,92
600,1,101,1,1,1,102
601,0,120,1,1,1,120
602,1,119,1,1,1,120
603,119,1,0,0,0,120
604,114,0,0,0,0,114
605,0,116,1,1,1,116
606,119,0,0,0,0,119
607,120,0,0,0,0,120
608,81,3,0,0,0,84
609,0,120,1,1,1,120
610,120,0,0,0,0,120
611,120,0,0,0,0,120
612,115,0,0,0,0,115
613,0,120,1,1,1,120
614,120,0,0,0,0,120
615,6,113,1,1,1,119
616,0,104,1,1,1,104
617,0,119,1,1,1,119
618,2,68,1,1,1,70
619,0,120,1,1,1,120
620,96,0,0,0,0,96
621,120,0,0,0,0,120
622,93,0,0,0,0,93
623,102,0,0,0,0,102
624,117,0,0,0,0,117
625,120,0,0,0,0,120
626,0,113,1,1,1,113
627,2,87,1,1,1,89
628,113,6,0,0,0,119
629,3,11,1,1,1,14
630,119,1,0,0,0,120
631,101,11,0,0,0,112
632,89,2,0,0,0,91
633,120,0,0,0,0,120
634,118,2,0,0,0,120
635,1,119,1,1,1,120
636,0,120,1,1,1,120
637,69,1,0,0,0,70
638,120,0,0,0,0,120
639,1,101,1,1,1,102
640,120,0,0,0,0,120
641,4,99,1,1,1,103
642,1,102,1,1,1,103
643,0,120,1,1,1,120
644,0,120,1,1,1,120
645,0,105,1,1,1,105
646,0,119,1,1,1,119
647,99,17,0,0,0,116
648,120,0,0,0,0,120
649,4,95,1,1,1,99
650,1,8,1,1,1,9
651,0,85,1,1,1,85
652,4,16,1,1,1,20
653,0,118,1,1,1,118
654,120,0,0,0,0,120
655,110,5,0,0,0,115
656,1,101,1,1,1,102
657,13,39,1,1,1,52
658,105,5,0,0,0,110
659,120,0,0,0,0,120
660,120,0,0,0,0,120
661,120,0,0,0,0,120
662,1,118,1,1,1,119
663,0,120,1,1,1,120
664,1,116,1,1,1,117
665,90,0,0,0,0,90
666,120,0,0,0,0,120
667,113,0,0,0,0,113
668,119,0,0,0,0,119
669,0,107,1,1,1,107
670,117,0,0,0,0,117
671,80,0,0,0,0,80
672,118,0,0,0,0,118
673,0,120,1,1,1,120
674,120,0,0,0,0,120
675,120,0,0,0,0,120
676,0,120,1,1,1,120
677,3,117,1,1,1,120
678,0,120,1,1,1,120
679,3,26,1,1,1,29
680,120,0,0,0,0,120
681,120,0,0,0,0,120
682,0,120,1,1,1,120
683,120,0,0,0,0,120
684,116,4,0,0,0,120
685,0,115,1,1,1,115
686,119,1,0,0,0,120
687,38,0,0,0,0,38
688,4,15,1,1,1,19
689,117,1,0,0,0,118
690,118,0,0,0,0,118
691,103,0,0,0,0,103
692,104,4,0,0,0,108
693,120,0,0,0,0,120
694,115,4,0,0,0,119
695,0,120,1,1,1,120
696,117,0,0,0,0,117
697,118,2,0,0,0,120
698,107,4,0,0,0,111
699,78,2,0,0,0,80
700,118,0,0,0,0,118
701,9,93,1,1,1,102
702,0,113,1,1,1,113
703,0,120,1,1,1,120
704,119,0,0,0,0,119
705,1,88,1,1,1,89
706,0,106,1,1,1,106
707,105,0,0,0,0,105
708,0,72,1,1,1,72
709,0,113,1,1,1,113
710,102,0,0,0,0,102
711,2,17,1,1,1,19
712,2,100,1,1,1,102
713,6,112,1,1,1,118
714,2,116,1,1,1,118
715,0,116,1,1,1,116
716,2,99,1,1,1,101
717,118,0,0,0,0,118
718,1,115,1,1,1,116
719,0,109,1,1,1,109
720,120,0,0,0,0,120
721,0,115,1,1,1,115
722,120,0,0,0,0,120
723,0,120,1,1,1,120
724,0,120,1,1,1,120
725,8,110,1,1,1,118
726,0,120,1,1,1,120
727,120,0,0,0,0,120
728,1,119,1,1,1,120
729,119,0,0,0,0,119
730,1,119,1,1,1,120
731,120,0,0,0,0,120
732,1,119,1,1,1,120
733,0,119,1,1,1,119
734,0,120,1,1,1,120
735,1,118,1,1,1,119
736,0,107,1,1,1,107
737,8,112,1,1,1,120
738,120,0,0,0,0,120
739,119,1,0,0,0,120
740,1,18,1,1,1,19
741,119,1,0,0,0,120
742,120,0,0,0,0,120
743,0,120,1,1,1,120
744,72,3,0,0,0,75
745,120,0,0,0,0,120
746,0,120,1,1,1,120
747,1,108,1,1,1,109
748,120,0,0,0,0,120
749,0,111,1,1,1,111
750,1,119,1,1,1,120
751,0,120,1,1,1,120
752,120,0,0,0,0,120
753,2,108,1,1,1,110
754,0,113,1,1,1,113
755,102,0,0,0,0,102
756,101,19,0,0,0,120
757,0,120,1,1,1,120
758,100,3,0,0,0,103
759,120,0,0,0,0,120
760,0,120,1,1,1,120
761,115,2,0,0,0,117
762,0,120,1,1,1,120
763,119,1,0,0,0,120
764,120,0,0,0,0,120
765,2,104,1,1,1,106
766,0,120,1,1,1,120
767,120,0,0,0,0,120
768,5,96,1,1,1,101
769,0,70,1,1,1,70
770,120,0,0,0,0,120
771,5,96,1,1,1,101
772,104,0,0,0,0,104
773,119,0,0,0,0,119
774,120,0,0,0,0,120
775,3,79,1,1,1,82
776,0,72,1,1,1,72
777,0,105,1,1,1,105
778,0,119,1,1,1,119
779,4,105,1,1,1,109
780,0,120,1,1,1,120
781,0,108,1,1,1,108
782,1,117,1,1,1,118
783,0,116,1,1,1,116
784,0,120,1,1,1,120
785,108,0,0,0,0,108
786,99,0,0,0,0,99
787,120,0,0,0,0,120
788,0,120,1,1,1,120
789,0,105,1,1,1,105
790,0,102,1,1,1,102
791,112,1,0,0,0,113
792,78,1,0,0,0,79
793,1,116,1,1,1,117
794,0,120,1,1,1,120
795,0,115,1,1,1,115
796,4,15,1,1,1,19
797,118,2,0,0,0,120
798,1,88,1,1,1,89
799,116,1,0,0,0,117
800,1,105,1,1,1,106
801,119,1,0,0,0,120
802,120,0,0,0,0,120
803,0,120,1,1,1,120
804,100,0,0,0,0,100
805,113,7,0,0,0,120
806,0,104,1,1,1,104
807,3,98,1,1,1,101
808,1,119,1,1,1,120
809,1,107,1,1,1,108
810,74,1,0,0,0,75
811,0,120,1,1,1,120
812,0,120,1,1,1,120
813,1,109,1,1,1,110
814,0,120,1,1,1,120
815,120,0,0,0,0,120
816,117,3,0,0,0,120
817,0,98,1,1,1,98
818,0,120,1,1,1,120
819,120,0,0,0,0,120
820,4,99,1,1,1,103
821,5,3,1,1,0,8
822,0,88,1,1,1,88
823,110,0,0,0,0,110
824,120,0,0,0,0,120
825,99,2,0,0,0,101
826,0,120,1,1,1,120
827,2,84,1,1,1,86
828,2,95,1,1,1,97
829,105,0,0,0,0,105
830,1,104,1,1,1,105
831,72,3,0,0,0,75
832,98,0,0,0,0,98
833,120,0,0,0,0,120
834,2,98,1,1,1,100
835,1,71,1,1,1,72
836,0,120,1,1,1,120
837,117,2,0,0,0,119
838,116,1,0,0,0,117
839,110,2,0,0,0,112
840,6,113,1,1,1,119
841,0,112,1,1,1,112
842,91,0,0,0,0,91
843,118,0,0,0,0,118
844,111,2,0,0,0,113
845,0,107,1,1,1,107
846,0,105,1,1,1,105
847,0,112,1,1,1,112
848,120,0,0,0,0,120
849,5,114,1,1,1,119
850,120,0,0,0,0,120
851,0,120,1,1,1,120
852,66,0,0,0,0,66
853,1,119,1,1,1,120
854,85,0,0,0,0,85
855,79,2,0,0,0,81
856,120,0,0,0,0,120
857,119,0,0,0,0,119
858,0,120,1,1,1,120
859,105,0,0,0,0,105
860,1,119,1,1,1,120
861,75,0,0,0,0,75
862,120,0,0,0,0,120
863,1,119,1,1,1,120
864,120,0,0,0,0,120
865,6,70,1,1,1,76
866,0,120,1,1,1,120
867,1,92,1,1,1,93
868,0,90,1,1,1,90
869,120,0,0,0,0,120
870,0,120,1,1,1,120
871,118,0,0,0,0,118
872,69,1,0,0,0,70
873,116,0,0,0,0,116
874,0,120,1,1,1,120
875,104,4,0,0,0,108
876,0,120,1,1,1,120
877,116,0,0,0,0,116
878,5,96,1,1,1,101
879,118,1,0,0,0,119
880,120,0,0,0,0,120
881,0,98,1,1,1,98
882,120,0,0,0,0,120
883,0,109,1,1,1,109
884,6,96,1,1,1,102
885,0,120,1,1,1,120
886,0,120,1,1,1,120
887,0,120,1,1,1,120
888,119,1,0,0,0,120
889,119,1,0,0,0,120
890,0,105,1,1,1,105
891,0,120,1,1,1,120
892,0,120,1,1,1,120
893,109,4,0,0,0,113
894,120,0,0,0,0,120
895,0,96,1,1,1,96
896,120,0,0,0,0,120
897,116,1,0,0,0,117
898,116,4,0,0,0,120
899,4,103,1,1,1,107
900,120,0,0,0,0,120
901,89,1,0,0,0,90
902,120,0,0,0,0,120
903,0,120,1,1,1,120
904,0,102,1,1,1,102
905,1,118,1,1,1,119
906,118,2,0,0,0,120
907,120,0,0,0,0,120
908,71,1,0,0,0,72
909,0,20,1,1,1,20
910,9,23,1,1,1,32
911,0,97,1,1,1,97
912,0,58,1,1,1,58
913,1,119,1,1,1,120
914,110,0,0,0,0,110
915,120,0,0,0,0,120
916,0,97,1,1,1,97
917,119,0,0,0,0,119
918,3,116,1,1,1,119
919,108,11,0,0,0,119
920,0,97,1,1,1,97
921,112,0,0,0,0,112
922,0,119,1,1,1,119
923,117,1,0,0,0,118
924,103,1,0,0,0,104
925,120,0,0,0,0,120
926,113,0,0,0,0,113
927,0,120,1,1,1,120
928,1,111,1,1,1,112
929,5,115,1,1,1,120
930,118,0,0,0,0,118
931,0,107,1,1,1,107
932,120,0,0,0,0,120
933,107,0,0,0,0,107
934,114,1,0,0,0,115
935,0,107,1,1,1,107
936,0,118,1,1,1,118
937,2,118,1,1,1,120
938,105,0,0,0,0,105
939,100,0,0,0,0,100
940,120,0,0,0,0,120
941,107,13,0,0,0,120
942,120,0,0,0,0,120
943,1,95,1,1,1,96
944,0,120,1,1,1,120
945,0,53,1,1,1,53
946,1,118,1,1,1,119
947,120,0,0,0,0,120
948,120,0,0,0,0,120
949,0,119,1,1,1,119
950,1,119,1,1,1,120
951,120,0,0,0,0,120
952,0,120,1,1,1,120
953,120,0,0,0,0,120
954,0,120,1,1,1,120
955,120,0,0,0,0,120
956,0,89,1,1,1,89
957,105,0,0,0,0,105
958,105,0,0,0,0,105
959,0,120,1,1,1,120
960,0,120,1,1,1,120
961,2,104,1,1,1,106
962,1,106,1,1,1,107
963,98,0,0,0,0,98
964,117,0,0,0,0,117
965,0,120,1,1,1,120
966,0,120,1,1,1,120
967,1,119,1,1,1,120
968,120,0,0,0,0,120
969,0,104,1,1,1,104
970,1,105,1,1,1,106
971,0,120,1,1,1,120
972,111,0,0,0,0,111
973,120,0,0,0,0,120
974,1,101,1,1,1,102
975,108,0,0,0,0,108
976,0,120,1,1,1,120
977,3,78,1,1,1,81
978,0,120,1,1,1,120
979,4,99,1,1,1,103
980,0,120,1,1,1,120
981,1,119,1,1,1,120
982,1,101,1,1,1,102
983,0,120,1,1,1,120
984,120,0,0,0,0,120
985,114,0,0,0,0,114
986,115,0,0,0,0,115
987,120,0,0,0,0,120
988,1,119,1,1,1,120
989,2,118,1,1,1,120
990,117,0,0,0,0,117
991,7,110,1,1,1,117
992,53,0,0,0,0,53
993,0,120,1,1,1,120
994,120,0,0,0,0,120
995,5,113,1,1,1,118
996,0,44,1,1,1,44
997,0,105,1,1,1,105
998,0,92,1,1,1,92
999,0,100,1,1,1,100
1000,119,0,0,0,0,119
1001,111,1,0,0,0,112
1002,0,120,1,1,1,120
1003,110,3,0,0,0,113
1004,120,0,0,0,0,120
1005,2,118,1,1,1,120
1006,99,0,0,0,0,99
1007,0,105,1,1,1,105
1008,3,117,1,1,1,120
1009,8,111,1,1,1,119
1010,0,116,1,1,1,116
1011,0,119,1,1,1,119
1012,0,120,1,1,1,120
1013,82,31,0,0,0,113
1014,117,3,0,0,0,120
1015,101,7,0,0,0,108
1016,0,120,1,1,1,120
1017,0,90,1,1,1,90
1018,0,91,1,1,1,91
1019,0,120,1,1,1,120
1020,120,0,0,0,0,120
1021,115,1,0,0,0,116
1022,0,120,1,1,1,120
1023,0,120,1,1,1,120
1024,0,109,1,1,1,109
1025,120,0,0,0,0,120
1026,1,119,1,1,1,120
1027,5,96,1,1,1,101
1028,0,115,1,1,1,115
1029,116,0,0,0,0,116
1030,2,102,1,1,1,104
1031,3,117,1,1,1,120
1032,6,96,1,1,1,102
1033,108,1,0,0,0,109
1034,70,3,0,0,0,73
1035,120,0,0,0,0,120
1036,0,105,1,1,1,105
1037,120,0,0,0,0,120
1038,11,109,1,1,1,120
1039,120,0,0,0,0,120
1040,120,0,0,0,0,120
1041,0,95,1,1,1,95
1042,112,1,0,0,0,113
1043,6,103,1,1,1,109
1044,110,0,0,0,0,110
1045,120,0,0,0,0,120
1046,0,120,1,1,1,120
1047,118,1,0,0,0,119
1048,120,0,0,0,0,120
1049,1,112,1,1,1,113
1050,0,120,1,1,1,120
1051,120,0,0,0,0,120
1052,0,91,1,1,1,91
1053,84,1,0,0,0,85
1054,109,1,0,0,0,110
1055,103,4,0,0,0,107
1056,117,0,0,0,0,117
1057,119,0,0,0,0,119
1058,4,116,1,1,1,120
1059,120,0,0,0,0,120
1060,119,0,0,0,0,119
1061,120,0,0,0,0,120
1062,0,120,1,1,1,120
1063,4,114,1,1,1,118
1064,7,109,1,1,1,116
1065,0,113,1,1,1,113
1066,115,1,0,0,0,116
1067,116,0,0,0,0,116
1068,0,113,1,1,1,113
1069,120,0,0,0,0,120
1070,0,120,1,1,1,120
1071,0,105,1,1,1,105
1072,120,0,0,0,0,120
1073,0,120,1,1,1,120
1074,0,116,1,1,1,116
1075,120,0,0,0,0,120
1076,118,0,0,0,0,118
1077,106,3,0,0,0,109
1078,76,5,0,0,0,81
1079,120,0,0,0,0,120
1080,120,0,0,0,0,120
1081,0,115,1,1,1,115
1082,119,0,0,0,0,119
1083,0,120,1,1,1,120
1084,0,77,1,1,1,77
1085,8,25,1,1,1,33
1086,120,0,0,0,0,120
1087,118,0,0,0,0,118
1088,1,119,1,1,1,120
1089,120,0,0,0,0,120
1090,119,0,0,0,0,119
1091,45,0,0,0,0,45
1092,1,105,1,1,1,106
1093,1,101,1,1,1,102
1094,0,105,1,1,1,105
1095,0,118,1,1,1,118
1096,120,0,0,0,0,120
1097,120,0,0,0,0,120
1098,0,106,1,1,1,106
1099,0,120,1,1,1,120
1100,118,0,0,0,0,118
1101,0,105,1,1,1,105
1102,0,107,1,1,1,107
1103,119,0,0,0,0,119
1104,120,0,0,0,0,120
1106,101,0,0,0,0,101
1107,114,6,0,0,0,120
1108,115,2,0,0,0,117
1109,1,118,1,1,1,119
1110,116,1,0,0,0,117
1111,1,86,1,1,1,87
1112,0,120,1,1,1,120
1113,0,120,1,1,1,120
1114,0,117,1,1,1,117
1115,0,115,1,1,1,115
1116,0,107,1,1,1,107
1117,0,120,1,1,1,120
1118,0,120,1,1,1,120
1119,0,120,1,1,1,120
1120,118,0,0,0,0,118
1121,120,0,0,0,0,120
1122,120,0,0,0,0,120
1123,5,96,1,1,1,101
1124,119,0,0,0,0,119
1125,2,100,1,1,1,102
1126,0,119,1,1,1,119
1127,120,0,0,0,0,120
1128,116,0,0,0,0,116
1129,2,118,1,1,1,120
1130,119,1,0,0,0,120
1131,89,7,0,0,0,96
1132,3,90,1,1,1,93
1133,1,103,1,1,1,104
1134,1,104,1,1,1,105
1135,116,1,0,0,0,117
1136,119,1,0,0,0,120
1137,0,120,1,1,1,120
1138,119,0,0,0,0,119
1139,0,114,1,1,1,114
1140,89,0,0,0,0,89
1141,1,119,1,1,1,120
1142,1,106,1,1,1,107
1143,1,108,1,1,1,109
1144,120,0,0,0,0,120
1145,120,0,0,0,0,120
1146,107,8,0,0,0,115
1147,119,0,0,0,0,119
1148,101,0,0,0,0,101
1149,4,91,1,1,1,95
1150,120,0,0,0,0,120
1151,118,0,0,0,0,118
1152,119,0,0,0,0,119
1153,117,3,0,0,0,120
1154,8,108,1,1,1,116
1155,0,98,1,1,1,98
1156,118,2,0,0,0,120
1157,6,114,1,1,1,120
1158,2,118,1,1,1,120
1159,9,111,1,1,1,120
1160,106,3,0,0,0,109
1161,111,0,0,0,0,111
1162,7,113,1,1,1,120
1163,1,119,1,1,1,120
1164,0,114,1,1,1,114
1165,120,0,0,0,0,120
1166,110,2,0,0,0,112
1167,2,118,1,1,1,120
1168,116,2,0,0,0,118
1169,117,0,0,0,0,117
1170,119,1,0,0,0,120
1171,4,99,1,1,1,103
1172,1,104,1,1,1,105
1173,0,120,1,1,1,120
1174,0,100,1,1,1,100
1175,1,105,1,1,1,106
1176,77,6,0,0,0,83
1177,1,119,1,1,1,120
1178,118,0,0,0,0,118
1179,4,114,1,1,1,118
1180,0,114,1,1,1,114
1181,1,118,1,1,1,119
1182,117,2,0,0,0,119
1183,4,16,1,1,1,20
1184,0,103,1,1,1,103
1185,118,1,0,0,0,119
1186,86,4,0,0,0,90
1187,117,0,0,0,0,117
1188,120,0,0,0,0,120
1189,4,116,1,1,1,120
1190,83,1,0,0,0,84
1191,120,0,0,0,0,120
1192,0,120,1,1,1,120
1193,0,108,1,1,1,108
1194,4,61,1,1,1,65
1195,120,0,0,0,0,120
1196,0,19,1,1,1,19
1197,0,98,1,1,1,98
1198,115,0,0,0,0,115
1199,0,83,1,1,1,83
1200,120,0,0,0,0,120
1201,112,0,0,0,0,112
1202,120,0,0,0,0,120
1203,120,0,0,0,0,120
1204,56,4,0,0,0,60
1205,13,104,1,1,1,117
1206,0,120,1,1,1,120
1207,0,113,1,1,1,113
1208,117,0,0,0,0,117
1209,0,119,1,1,1,119
1210,76,3,0,0,0,79
1211,1,104,1,1,1,105
1212,120,0,0,0,0,120
1213,108,0,0,0,0,108
1214,0,120,1,1,1,120
1215,0,118,1,1,1,118
1216,2,118,1,1,1,120
1217,120,0,0,0,0,120
1218,119,1,0,0,0,120
1219,0,111,1,1,1,111
1220,4,99,1,1,1,103
1221,75,5,0,0,0,80
1222,2,10,1,1,1,12
1223,120,0,0,0,0,120
1224,1,118,1,1,1,119
1225,117,3,0,0,0,120
1226,91,0,0,0,0,91
1227,112,0,0,0,0,112
1228,0,120,1,1,1,120
1229,0,119,1,1,1,119
1230,1,88,1,1,1,89
1231,118,1,0,0,0,119
1232,78,5,0,0,0,83
1233,101,0,0,0,0,101
1234,119,0,0,0,0,119
1235,0,120,1,1,1,120
1236,0,119,1,1,1,119
1237,120,0,0,0,0,120
1238,0,120,1,1,1,120
1239,118,2,0,0,0,120
1240,1,119,1,1,1,120
1241,0,120,1,1,1,120
1242,120,0,0,0,0,120
1243,119,0,0,0,0,119
1244,2,101,1,1,1,103
1245,74,0,0,0,0,74
1246,58,0,0,0,0,58
1247,1,89,1,1,1,90
1248,106,3,0,0,0,109
1249,0,105,1,1,1,105
1250,74,0,0,0,0,74
1251,120,0,0,0,0,120
1252,2,116,1,1,1,118
1253,1,105,1,1,1,106
1254,116,3,0,0,0,119
1255,106,1,0,0,0,107
1256,4,115,1,1,1,119
1257,0,105,1,1,1,105
1258,0,120,1,1,1,120
1259,120,0,0,0,0,120
1260,116,4,0,0,0,120
1261,3,106,1,1,1,109
1262,0,99,1,1,1,99
1263,0,75,1,1,1,75
1264,107,0,0,0,0,107
1265,120,0,0,0,0,120
1266,1,94,1,1,1,95
1267,101,18,0,0,0,119
1268,117,0,0,0,0,117
1269,120,0,0,0,0,120
1270,112,7,0,0,0,119
1271,84,1,0,0,0,85
1272,6,114,1,1,1,120
1273,0,120,1,1,1,120
1274,0,89,1,1,1,89
1275,1,105,1,1,1,106
1276,0,120,1,1,1,120
1277,103,0,0,0,0,103
1278,105,0,0,0,0,105
1279,1,118,1,1,1,119
1280,120,0,0,0,0,120
1281,120,0,0,0,0,120
1282,116,4,0,0,0,120
1283,14,36,1,1,1,50
1284,0,99,1,1,1,99
1285,0,118,1,1,1,118
1286,0,113,1,1,1,113
1287,120,0,0,0,0,120
1288,0,120,1,1,1,120
1289,1,117,1,1,1,118
1290,4,86,1,1,1,90
1291,120,0,0,0,0,120
1292,0,120,1,1,1,120
1293,1,119,1,1,1,120
1294,62,9,0,0,0,71
1295,119,0,0,0,0,119
1296,1,119,1,1,1,120
1297,0,120,1,1,1,120
1298,108,0,0,0,0,108
1299,0,120,1,1,1,120
1300,1,119,1,1,1,120
1301,1,107,1,1,1,108
1302,0,120,1,1,1,120
1303,6,114,1,1,1,120
1304,120,0,0,0,0,120
1305,0,105,1,1,1,105
1306,0,119,1,1,1,119
1307,120,0,0,0,0,120
1308,120,0,0,0,0,120
1309,0,120,1,1,1,120
1310,120,0,0,0,0,120
1311,110,2,0,0,0,112
1312,0,70,1,1,1,70
1313,0,120,1,1,1,120
1314,0,120,1,1,1,120
1315,3,57,1,1,1,60
1316,1,101,1,1,1,102
1317,120,0,0,0,0,120
1318,0,120,1,1,1,120
1319,1,2,1,1,1,3
1320,3,86,1,1,1,89
1321,115,1,0,0,0,116
1322,120,0,0,0,0,120
1323,0,118,1,1,1,118
1324,0,105,1,1,1,105
1325,0,120,1,1,1,120
1326,0,120,1,1,1,120
1327,0,115,1,1,1,115
1328,117,1,0,0,0,118
1329,4,99,1,1,1,103
1330,104,1,0,0,0,105
1331,64,3,0,0,0,67
1332,118,2,0,0,0,120
1333,0,111,1,1,1,111
1334,1,119,1,1,1,120
1335,0,103,1,1,1,103
1336,120,0,0,0,0,120
1337,0,120,1,1,1,120
1338,0,105,1,1,1,105
1339,9,107,1,1,1,116
1340,3,115,1,1,1,118
1341,120,0,0,0,0,120
1342,1,116,1,1,1,117
1343,75,5,0,0,0,80
1344,120,0,0,0,0,120
1345,0,49,1,1,1,49
1346,0,120,1,1,1,120
1347,0,120,1,1,1,120
1348,0,120,1,1,1,120
1349,1,102,1,1,1,103
1350,120,0,0,0,0,120
1351,1,119,1,1,1,120
1352,93,0,0,0,0,93
1353,1,106,1,1,1,107
1354,118,2,0,0,0,120
1355,120,0,0,0,0,120
1356,75,5,0,0,0,80
1357,1,105,1,1,1,106
1358,114,3,0,0,0,117
1359,119,1,0,0,0,120
1360,1,118,1,1,1,119
1361,64,1,0,0,0,65
1362,0,120,1,1,1,120
1363,120,0,0,0,0,120
1364,0,116,1,1,1,116
1365,48,2,0,0,0,50
1366,1,104,1,1,1,105
1367,1,90,1,1,1,91
1368,90,25,0,0,0,115
1369,114,0,0,0,0,114
1370,105,4,0,0,0,109
1371,120,0,0,0,0,120
1372,4,103,1,1,1,107
1373,0,120,1,1,1,120
1374,118,0,0,0,0,118
1375,2,98,1,1,1,100
1376,24,26,0,0,1,50
1377,68,0,0,0,0,68
1378,96,0,0,0,0,96
1379,120,0,0,0,0,120
1380,120,0,0,0,0,120
1381,105,0,0,0,0,105
1382,0,120,1,1,1,120
1383,113,7,0,0,0,120
1384,0,90,1,1,1,90
1385,113,1,0,0,0,114
1386,117,0,0,0,0,117
1387,1,117,1,1,1,118
1388,1,113,1,1,1,114
1389,114,6,0,0,0,120
1390,120,0,0,0,0,120
1391,120,0,0,0,0,120
1392,0,120,1,1,1,120
1393,0,120,1,1,1,120
1394,110,0,0,0,0,110
1395,0,101,1,1,1,101
1396,110,2,0,0,0,112
1397,1,117,1,1,1,118
1398,51,0,0,0,0,51
1399,119,1,0,0,0,120
1400,120,0,0,0,0,120
1401,0,84,1,1,1,84
1402,119,0,0,0,0,119
1403,0,117,1,1,1,117
1404,99,0,0,0,0,99
1405,0,118,1,1,1,118
1406,61,0,0,0,0,61
1407,114,4,0,0,0,118
1408,119,1,0,0,0,120
1409,1,117,1,1,1,118
1410,1,116,1,1,1,117
1411,120,0,0,0,0,120
1412,0,105,1,1,1,105
1413,6,96,1,1,1,102
1414,119,1,0,0,0,120
1415,0,120,1,1,1,120
1416,120,0,0,0,0,120
1417,0,120,1,1,1,120
1418,0,80,1,1,1,80
1419,120,0,0,0,0,120
1420,0,95,1,1,1,95
1421,117,0,0,0,0,117
1422,1,105,1,1,1,106
1423,0,115,1,1,1,115
1424,0,113,1,1,1,113
1425,116,2,0,0,0,118
1426,118,0,0,0,0,118
1427,1,105,1,1,1,106
1428,120,0,0,0,0,120
1429,3,102,1,1,1,105
1430,0,91,1,1,1,91
1431,101,0,0,0,0,101
1432,0,120,1,1,1,120
1433,0,87,1,1,1,87
1434,94,0,0,0,0,94
1435,0,103,1,1,1,103
1436,119,0,0,0,0,119
1437,0,120,1,1,1,120
1438,54,2,0,0,0,56
1439,100,0,0,0,0,100
1440,0,120,1,1,1,120
1441,120,0,0,0,0,120
1442,2,103,1,1,1,105
1443,104,2,0,0,0,106
1444,4,105,1,1,1,109
1445,1,119,1,1,1,120
1446,113,0,0,0,0,113
1447,70,1,0,0,0,71
1448,120,0,0,0,0,120
1449,0,86,1,1,1,86
1450,116,3,0,0,0,119
1451,120,0,0,0,0,120
1452,116,4,0,0,0,120
1453,119,0,0,0,0,119
1454,116,0,0,0,0,116
1455,105,0,0,0,0,105
1456,120,0,0,0,0,120
1457,1,92,1,1,1,93
1458,0,97,1,1,1,97
1459,0,120,1,1,1,120
1460,4,116,1,1,1,120
1461,119,0,0,0,0,119
1462,0,120,1,1,1,120
1463,1,118,1,1,1,119
1464,120,0,0,0,0,120
1465,118,2,0,0,0,120
1466,120,0,0,0,0,120
1467,2,118,1,1,1,120
1468,0,120,1,1,1,120
1469,0,115,1,1,1,115
1470,120,0,0,0,0,120
1471,120,0,0,0,0,120
1472,5,101,1,1,1,106
1473,120,0,0,0,0,120
1474,11,102,1,1,1,113
1475,2,117,1,1,1,119
1476,118,0,0,0,0,118
1477,1,119,1,1,1,120
1478,119,0,0,0,0,119
1479,0,120,1,1,1,120
1480,0,120,1,1,1,120
1481,0,93,1,1,1,93
1482,0,120,1,1,1,120
1483,118,0,0,0,0,118
1484,119,0,0,0,0,119
1485,111,0,0,0,0,111
1486,0,120,1,1,1,120
1487,120,0,0,0,0,120
1488,5,96,1,1,1,101
1489,114,0,0,0,0,114
1490,1,119,1,1,1,120
1491,0,31,1,1,1,31
1492,119,0,0,0,0,119
1493,0,92,1,1,1,92
1494,3,91,1,1,1,94
1495,120,0,0,0,0,120
1496,120,0,0,0,0,120
1497,1,88,1,1,1,89
1498,120,0,0,0,0,120
1499,120,0,0,0,0,120
1500,4,90,1,1,1,94
1501,116,1,0,0,0,117
1502,45,0,0,0,0,45
1503,1,105,1,1,1,106
1504,0,120,1,1,1,120
1505,120,0,0,0,0,120
1506,106,4,0,0,0,110
1507,120,0,0,0,0,120
1508,66,12,0,0,0,78
1509,120,0,0,0,0,120
1510,1,119,1,1,1,120
1511,119,0,0,0,0,119
1512,105,0,0,0,0,105
1513,0,113,1,1,1,113
1514,3,115,1,1,1,118
1515,0,120,1,1,1,120
1516,0,89,1,1,1,89
1517,0,105,1,1,1,105
1518,4,116,1,1,1,120
1519,117,3,0,0,0,120
1520,9,102,1,1,1,111
1521,0,120,1,1,1,120
1522,0,120,1,1,1,120
1523,0,109,1,1,1,109
1524,72,4,0,0,0,76
1525,120,0,0,0,0,120
1526,119,0,0,0,0,119
1527,5,0,0,1,0,5
1528,0,100,1,1,1,100
1529,105,0,0,0,0,105
1530,119,1,0,0,0,120
1531,111,0,0,0,0,111
1532,0,97,1,1,1,97
1533,2,93,1,1,1,95
1534,120,0,0,0,0,120
1535,120,0,0,0,0,120
1536,2,100,1,1,1,102
1537,82,0,0,0,0,82
1538,6,96,1,1,1,102
1539,120,0,0,0,0,120
1540,5,114,1,1,1,119
1541,0,105,1,1,1,105
1542,0,95,1,1,1,95
1543,0,102,1,1,1,102
1544,117,0,0,0,0,117
1545,0,70,1,1,1,70
1546,107,0,0,0,0,107
1547,0,113,1,1,1,113
1548,84,0,0,0,0,84
1549,0,120,1,1,1,120
1550,1,119,1,1,1,120
1551,2,110,1,1,1,112
1552,0,120,1,1,1,120
1553,120,0,0,0,0,120
1554,0,114,1,1,1,114
1555,0,103,1,1,1,103
1556,120,0,0,0,0,120
1557,2,10,1,1,1,12
1558,119,1,0,0,0,120
1559,8,112,1,1,1,120
1560,120,0,0,0,0,120
1561,117,1,0,0,0,118
1562,0,116,1,1,1,116
1563,120,0,0,0,0,120
1564,0,119,1,1,1,119
1565,0,120,1,1,1,120
1566,2,102,1,1,1,104
1567,2,118,1,1,1,120
1568,120,0,0,0,0,120
1569,0,120,1,1,1,120
1570,119,0,0,0,0,119
1571,0,110,1,1,1,110
1572,3,117,1,1,1,120
1573,117,0,0,0,0,117
1574,3,116,1,1,1,119
1575,120,0,0,0,0,120
1576,107,0,0,0,0,107
1577,0,92,1,1,1,92
1578,0,117,1,1,1,117
1579,2,100,1,1,1,102
1580,5,114,1,1,1,119
1581,119,1,0,0,0,120
1582,1,119,1,1,1,120
1583,61,1,0,0,0,62
1584,0,98,1,1,1,98
1585,0,115,1,1,1,115
1586,120,0,0,0,0,120
1587,116,4,0,0,0,120
1588,0,120,1,1,1,120
1589,1,118,1,1,1,119
1590,114,6,0,0,0,120
1591,117,3,0,0,0,120
1592,118,2,0,0,0,120
1593,1,105,1,1,1,106
1594,0,104,1,1,1,104
1595,120,0,0,0,0,120
1596,0,91,1,1,1,91
1597,1,118,1,1,1,119
1598,1,119,1,1,1,120
1599,117,2,0,0,0,119
1600,4,99,1,1,1,103
1601,120,0,0,0,0,120
1602,120,0,0,0,0,120
1603,120,0,0,0,0,120
1604,2,98,1,1,1,100
1605,120,0,0,0,0,120
1606,0,110,1,1,1,110
1607,64,0,0,0,0,64
1608,0,73,1,1,1,73
1609,1,119,1,1,1,120
1610,18,86,1,1,1,104
1611,120,0,0,0,0,120
1612,2,97,1,1,1,99
1613,120,0,0,0,0,120
1614,5,96,1,1,1,101
1615,0,120,1,1,1,120
1616,118,0,0,0,0,118
1617,120,0,0,0,0,120
1618,114,0,0,0,0,114
1619,0,81,1,1,1,81
1620,0,120,1,1,1,120
1621,118,2,0,0,0,120
1622,120,0,0,0,0,120
1623,0,120,1,1,1,120
1624,1,105,1,1,1,106
1625,2,118,1,1,1,120
1626,0,93,1,1,1,93
1627,106,0,0,0,0,106
1628,120,0,0,0,0,120
1629,104,2,0,0,0,106
1630,3,104,1,1,1,107
1631,116,0,0,0,0,116
1632,117,0,0,0,0,117
1633,120,0,0,0,0,120
1634,65,0,0,0,0,65
1635,8,110,1,1,1,118
1636,117,0,0,0,0,117
1637,120,0,0,0,0,120
1638,120,0,0,0,0,120
1639,1,116,1,1,1,117
1640,120,0,0,0,0,120
1641,118,0,0,0,0,118
1642,117,0,0,0,0,117
1643,117,0,0,0,0,117
1644,120,0,0,0,0,120
1645,0,42,1,1,1,42
1646,0,120,1,1,1,120
1647,1,116,1,1,1,117
1648,110,5,0,0,0,115
1649,0,54,1,1,1,54
1650,0,104,1,1,1,104
1651,93,0,0,0,0,93
1652,120,0,0,0,0,120
1653,4,116,1,1,1,120
1654,0,120,1,1,1,120
1655,0,88,1,1,1,88
1656,120,0,0,0,0,120
1657,120,0,0,0,0,120
1658,110,6,0,0,0,116
1659,103,0,0,0,0,103
1660,119,1,0,0,0,120
1661,119,1,0,0,0,120
1663,1,119,1,1,1,120
1664,8,110,1,1,1,118
1665,93,1,0,0,0,94
1666,120,0,0,0,0,120
1667,118,2,0,0,0,120
1668,95,2,0,0,0,97
1669,120,0,0,0,0,120
1670,120,0,0,0,0,120
1671,2,91,1,1,1,93
1672,114,0,0,0,0,114
1673,120,0,0,0,0,120
1674,105,0,0,0,0,105
1675,1,104,1,1,1,105
1676,120,0,0,0,0,120
1677,76,0,0,0,0,76
1678,105,0,0,0,0,105
1679,11,94,1,1,1,105
1680,3,117,1,1,1,120
1681,56,0,0,0,0,56
1682,0,120,1,1,1,120
1683,112,2,0,0,0,114
1684,97,0,0,0,0,97
1685,96,24,0,0,0,120
1686,0,120,1,1,1,120
1687,120,0,0,0,0,120
1689,0,96,1,1,1,96
1690,106,0,0,0,0,106
1691,117,0,0,0,0,117
1692,1,108,1,1,1,109
1693,0,87,1,1,1,87
1694,120,0,0,0,0,120
1695,65,1,0,0,0,66
1696,0,120,1,1,1,120
1697,120,0,0,0,0,120
1698,3,115,1,1,1,118
1699,116,0,0,0,0,116
1700,2,104,1,1,1,106
1701,0,118,1,1,1,118
1702,59,0,0,0,0,59
1703,82,2,0,0,0,84
1704,0,101,1,1,1,101
1705,0,107,1,1,1,107
1706,120,0,0,0,0,120
1707,0,120,1,1,1,120
1708,1,104,1,1,1,105
1709,7,92,1,1,1,99
1710,0,102,1,1,1,102
1711,3,117,1,1,1,120
1712,115,0,0,0,0,115
1713,119,0,0,0,0,119
1714,62,0,0,0,0,62
1715,112,0,0,0,0,112
1716,120,0,0,0,0,120
1717,117,0,0,0,0,117
1718,1,101,1,1,1,102
1719,0,120,1,1,1,120
1720,1,85,1,1,1,86
1721,0,116,1,1,1,116
1722,120,0,0,0,0,120
1723,1,103,1,1,1,104
1724,1,119,1,1,1,120
1725,1,99,1,1,1,100
1726,0,105,1,1,1,105
1727,102,3,0,0,0,105
1728,105,0,0,0,0,105
1729,4,116,1,1,1,120
1730,0,120,1,1,1,120
1731,0,120,1,1,1,120
1732,120,0,0,0,0,120
1733,0,95,1,1,1,95
1734,2,116,1,1,1,118
1735,1,92,1,1,1,93
1736,117,3,0,0,0,120
1737,3,98,1,1,1,101
1738,120,0,0,0,0,120
1739,111,5,0,0,0,116
1740,0,120,1,1,1,120
1741,1,94,1,1,1,95
1742,1,119,1,1,1,120
1743,120,0,0,0,0,120
1744,1,104,1,1,1,105
1745,120,0,0,0,0,120
1746,0,51,1,1,1,51
1747,0,102,1,1,1,102
1748,107,1,0,0,0,108
1749,3,117,1,1,1,120
1750,0,120,1,1,1,120
1751,105,0,0,0,0,105
1752,120,0,0,0,0,120
1753,79,2,0,0,0,81
1754,120,0,0,0,0,120
1755,0,119,1,1,1,119
1756,115,0,0,0,0,115
1757,0,100,1,1,1,100
1758,0,118,1,1,1,118
1759,93,10,0,0,0,103
1760,119,0,0,0,0,119
1761,120,0,0,0,0,120
1762,105,0,0,0,0,105
1763,10,107,1,1,1,117
1764,111,9,0,0,0,120
1765,0,120,1,1,1,120
1766,0,104,1,1,1,104
1767,1,119,1,1,1,120
1768,0,120,1,1,1,120
1769,120,0,0,0,0,120
1770,120,0,0,0,0,120
1771,1,119,1,1,1,120
1772,0,107,1,1,1,107
1773,116,2,0,0,0,118
1774,120,0,0,0,0,120
1775,1,89,1,1,1,90
1776,78,3,0,0,0,81
1777,113,7,0,0,0,120
1778,0,120,1,1,1,120
1779,0,120,1,1,1,120
1780,0,119,1,1,1,119
1781,120,0,0,0,0,120
1782,0,113,1,1,1,113
1783,0,102,1,1,1,102
1784,106,8,0,0,0,114
1785,0,99,1,1,1,99
1786,104,0,0,0,0,104
1787,4,99,1,1,1,103
1788,0,105,1,1,1,105
1789,1,105,1,1,1,106
1790,0,101,1,1,1,101
1791,0,104,1,1,1,104
1792,120,0,0,0,0,120
1793,0,120,1,1,1,120
1794,120,0,0,0,0,120
1795,120,0,0,0,0,120
1796,117,0,0,0,0,117
1797,2,118,1,1,1,120
1798,0,107,1,1,1,107
1799,120,0,0,0,0,120
1800,114,1,0,0,0,115
1801,120,0,0,0,0,120
1802,0,120,1,1,1,120
1803,1,119,1,1,1,120
1804,0,120,1,1,1,120
1805,115,0,0,0,0,115
1806,113,1,0,0,0,114
1807,0,105,1,1,1,105
1808,116,0,0,0,0,116
1809,0,120,1,1,1,120
1810,108,11,0,0,0,119
1812,0,102,1,1,1,102
1813,116,3,0,0,0,119
1814,0,120,1,1,1,120
1815,119,0,0,0,0,119
1816,65,0,0,0,0,65
1817,0,120,1,1,1,120
1818,114,0,0,0,0,114
1819,112,3,0,0,0,115
1820,107,12,0,0,0,119
1821,120,0,0,0,0,120
1822,118,2,0,0,0,120
1823,4,61,1,1,1,65
1824,120,0,0,0,0,120
1826,98,0,0,0,0,98
1827,77,0,0,0,0,77
1828,0,119,1,1,1,119
1829,1,114,1,1,1,115
1830,0,120,1,1,1,120
1831,0,119,1,1,1,119
1832,1,99,1,1,1,100
1833,120,0,0,0,0,120
1834,0,115,1,1,1,115
1835,0,120,1,1,1,120
1836,117,0,0,0,0,117
1837,113,0,0,0,0,113
1838,3,100,1,1,1,103
1839,0,13,1,1,1,13
1840,120,0,0,0,0,120
1841,96,3,0,0,0,99
1842,6,69,1,1,1,75
1843,119,1,0,0,0,120
1844,1,88,1,1,1,89
1845,0,113,1,1,1,113
1846,0,105,1,1,1,105
1847,115,0,0,0,0,115
1848,0,96,1,1,1,96
1849,2,118,1,1,1,120
1850,91,0,0,0,0,91
1851,120,0,0,0,0,120
1852,0,120,1,1,1,120
1853,90,2,0,0,0,92
1854,120,0,0,0,0,120
1855,120,0,0,0,0,120
1856,120,0,0,0,0,120
1857,3,117,1,1,1,120
1858,116,0,0,0,0,116
1859,0,112,1,1,1,112
1860,0,105,1,1,1,105
1861,0,70,1,1,1,70
1862,0,120,1,1,1,120
1863,120,0,0,0,0,120
1864,113,0,0,0,0,113
1865,120,0,0,0,0,120
1866,0,73,1,1,1,73
1867,117,0,0,0,0,117
1868,4,56,1,1,1,60
1869,0,120,1,1,1,120
1870,68,2,0,0,0,70
1871,120,0,0,0,0,120
1872,0,120,1,1,1,120
1873,55,0,0,0,0,55
1874,4,87,1,1,1,91
1875,1,106,1,1,1,107
1876,120,0,0,0,0,120
1877,119,1,0,0,0,120
1878,0,105,1,1,1,105
1879,120,0,0,0,0,120
1880,1,107,1,1,1,108
1881,104,0,0,0,0,104
1882,118,0,0,0,0,118
1883,93,0,0,0,0,93
1884,120,0,0,0,0,120
1885,42,3,0,0,0,45
1886,117,3,0,0,0,120
1887,5,96,1,1,1,101
1888,4,105,1,1,1,109
1889,1,81,1,1,1,82
1890,0,56,1,1,1,56
1891,81,10,0,0,0,91
1892,1,119,1,1,1,120
1893,118,0,0,0,0,118
1894,4,15,1,1,1,19
1895,2,43,1,1,1,45
1896,119,0,0,0,0,119
1897,1,114,1,1,1,115
1898,119,0,0,0,0,119
1899,0,117,1,1,1,117
1900,1,113,1,1,1,114
1901,88,5,0,0,0,93
1902,0,120,1,1,1,120
1903,120,0,0,0,0,120
1904,119,1,0,0,0,120
1905,1,119,1,1,1,120
1906,119,0,0,0,0,119
1907,0,120,1,1,1,120
1908,6,82,1,1,1,88
1909,0,120,1,1,1,120
1910,1,105,1,1,1,106
1911,87,0,0,0,0,87
1912,0,120,1,1,1,120
1913,0,105,1,1,1,105
1914,111,0,0,0,0,111
1915,120,0,0,0,0,120
1916,0,91,1,1,1,91
1917,119,0,0,0,0,119
1918,2,104,1,1,1,106
1919,0,120,1,1,1,120
1920,1,105,1,1,1,106
1921,118,1,0,0,0,119
1922,0,99,1,1,1,99
1923,115,5,0,0,0,120
1924,2,118,1,1,1,120
1925,6,112,1,1,1,118
1926,1,94,1,1,1,95
1927,120,0,0,0,0,120
1928,96,0,0,0,0,96
1929,0,43,1,1,1,43
1930,117,3,0,0,0,120
1931,0,118,1,1,1,118
1932,118,2,0,0,0,120
1933,0,120,1,1,1,120
1934,0,120,1,1,1,120
1935,116,4,0,0,0,120
1936,2,102,1,1,1,104
1937,105,0,0,0,0,105
1938,116,4,0,0,0,120
1939,1,105,1,1,1,106
1940,119,0,0,0,0,119
1941,120,0,0,0,0,120
1942,0,108,1,1,1,108
1943,119,1,0,0,0,120
1944,120,0,0,0,0,120
1945,120,0,0,0,0,120
1946,0,120,1,1,1,120
1947,0,120,1,1,1,120
1948,120,0,0,0,0,120
1949,120,0,0,0,0,120
1950,120,0,0,0,0,120
1951,2,103,1,1,1,105
1952,0,120,1,1,1,120
1953,0,118,1,1,1,118
1954,0,56,1,1,1,56
1955,120,0,0,0,0,120
1956,0,115,1,1,1,115
1957,90,0,0,0,0,90
1958,120,0,0,0,0,120
1959,92,13,0,0,0,105
1960,1,119,1,1,1,120
1961,120,0,0,0,0,120
1962,0,120,1,1,1,120
1963,0,120,1,1,1,120
1964,119,1,0,0,0,120
1965,120,0,0,0,0,120
1966,116,1,0,0,0,117
1967,74,0,0,0,0,74
1968,0,102,1,1,1,102
1969,107,0,0,0,0,107
1970,119,1,0,0,0,120
1971,72,0,0,0,0,72
1972,119,1,0,0,0,120
1973,1,119,1,1,1,120
1974,120,0,0,0,0,120
1975,120,0,0,0,0,120
1976,120,0,0,0,0,120
1977,0,120,1,1,1,120
1978,0,117,1,1,1,117
1979,103,0,0,0,0,103
1980,0,109,1,1,1,109
1981,28,0,0,0,0,28
1982,1,89,1,1,1,90
1983,118,0,0,0,0,118
1984,0,120,1,1,1,120
1985,120,0,0,0,0,120
1986,5,115,1,1,1,120
1987,0,113,1,1,1,113
1988,120,0,0,0,0,120
1989,120,0,0,0,0,120
1990,107,0,0,0,0,107
1991,0,120,1,1,1,120
1992,1,119,1,1,1,120
1993,0,104,1,1,1,104
1994,120,0,0,0,0,120
1995,2,5,1,1,1,7
1996,3,114,1,1,1,117
1997,102,0,0,0,0,102
1998,107,0,0,0,0,107
1999,0,93,1,1,1,93
2000,117,0,0,0,0,117
2001,95,3,0,0,0,98
2002,120,0,0,0,0,120
2003,113,1,0,0,0,114
2004,116,0,0,0,0,116
2005,120,0,0,0,0,120
2006,106,0,0,0,0,106
2007,108,0,0,0,0,108
2008,0,99,1,1,1,99
2009,120,0,0,0,0,120
2010,90,0,0,0,0,90
2011,1,104,1,1,1,105
2012,118,0,0,0,0,118
2013,0,114,1,1,1,114
2014,1,119,1,1,1,120
2015,120,0,0,0,0,120
2016,0,120,1,1,1,120
2017,5,96,1,1,1,101
2018,0,113,1,1,1,113
2019,120,0,0,0,0,120
2020,120,0,0,0,0,120
2021,120,0,0,0,0,120
2022,118,0,0,0,0,118
2023,0,115,1,1,1,115
2024,4,84,1,1,1,88
2025,5,96,1,1,1,101
2026,120,0,0,0,0,120
2027,58,0,0,0,0,58
2028,120,0,0,0,0,120
2029,105,0,0,0,0,105
2030,97,1,0,0,0,98
2031,98,0,0,0,0,98
2032,1,92,1,1,1,93
2033,117,1,0,0,0,118
2034,83,1,0,0,0,84
2035,0,68,1,1,1,68
2037,1,68,1,1,1,69
2038,1,88,1,1,1,89
2039,109,1,0,0,0,110
2040,116,0,0,0,0,116
2041,0,120,1,1,1,120
2042,120,0,0,0,0,120
2043,0,119,1,1,1,119
2044,118,1,0,0,0,119
2045,13,0,0,0,0,13
2046,3,116,1,1,1,119
2047,65,3,0,0,0,68
2048,0,120,1,1,1,120
2049,2,118,1,1,1,120
2050,0,104,1,1,1,104
2051,119,1,0,0,0,120
2052,0,106,1,1,1,106
2053,0,118,1,1,1,118
2054,6,108,1,1,1,114
2055,100,20,0,0,0,120
2056,110,2,0,0,0,112
2057,73,6,0,0,0,79
2058,120,0,0,0,0,120
2059,116,0,0,0,0,116
2060,6,114,1,1,1,120
2061,118,0,0,0,0,118
2062,120,0,0,0,0,120
2063,120,0,0,0,0,120
2064,4,104,1,1,1,108
2065,106,0,0,0,0,106
2066,0,116,1,1,1,116
2067,120,0,0,0,0,120
2068,120,0,0,0,0,120
2069,120,0,0,0,0,120
2070,106,0,0,0,0,106
2071,0,105,1,1,1,105
2072,0,120,1,1,1,120
2073,0,110,1,1,1,110
2074,3,115,1,1,1,118
2075,1,118,1,1,1,119
2076,1,117,1,1,1,118
2077,116,4,0,0,0,120
2078,85,1,0,0,0,86
2079,0,120,1,1,1,120
2080,6,53,1,1,1,59
2081,3,117,1,1,1,120
2082,0,120,1,1,1,120
2083,120,0,0,0,0,120
2084,120,0,0,0,0,120
2085,117,2,0,0,0,119
2086,119,0,0,0,0,119
2087,120,0,0,0,0,120
2088,87,0,0,0,0,87
2089,0,120,1,1,1,120
2090,7,46,1,1,1,53
2091,120,0,0,0,0,120
2092,0,67,1,1,1,67
2093,120,0,0,0,0,120
2094,93,0,0,0,0,93
2095,0,120,1,1,1,120
2096,108,2,0,0,0,110
2097,0,105,1,1,1,105
2098,120,0,0,0,0,120
2099,2,118,1,1,1,120
2100,0,118,1,1,1,118
2101,1,88,1,1,1,89
2102,107,2,0,0,0,109
2103,0,96,1,1,1,96
2104,119,1,0,0,0,120
2105,0,120,1,1,1,120
2106,0,104,1,1,1,104
2107,106,0,0,0,0,106
2108,120,0,0,0,0,120
2109,2,100,1,1,1,102
2110,105,0,0,0,0,105
2111,120,0,0,0,0,120
2112,120,0,0,0,0,120
2113,120,0,0,0,0,120
2114,2,118,1,1,1,120
2115,120,0,0,0,0,120
2116,62,0,0,0,0,62
2117,0,120,1,1,1,120
2118,118,0,0,0,0,118
2119,119,0,0,0,0,119
2120,76,0,0,0,0,76
2121,0,120,1,1,1,120
2122,0,109,1,1,1,109
2123,8,108,1,1,1,116
2124,106,0,0,0,0,106
2125,0,120,1,1,1,120
2126,64,2,0,0,0,66
2127,0,108,1,1,1,108
2128,4,116,1,1,1,120
2129,0,120,1,1,1,120
2130,115,0,0,0,0,115
2131,1,115,1,1,1,116
2132,117,0,0,0,0,117
2133,119,1,0,0,0,120
2134,30,0,0,0,0,30
2135,118,2,0,0,0,120
2136,1,119,1,1,1,120
2137,1,112,1,1,1,113
2138,101,1,0,0,0,102
2139,120,0,0,0,0,120
2140,92,0,0,0,0,92
2141,1,106,1,1,1,107
2142,0,97,1,1,1,97
2143,3,97,1,1,1,100
2144,105,0,0,0,0,105
2145,119,1,0,0,0,120
2146,120,0,0,0,0,120
2147,28,1,0,0,0,29
2148,120,0,0,0,0,120
2149,2,10,1,1,1,12
2150,120,0,0,0,0,120
2151,0,114,1,1,1,114
2152,104,3,0,0,0,107
2153,98,1,0,0,0,99
2154,0,120,1,1,1,120
2155,119,0,0,0,0,119
2156,0,120,1,1,1,120
2157,15,18,1,1,1,33
2158,120,0,0,0,0,120
2159,120,0,0,0,0,120
2160,1,113,1,1,1,114
2161,91,2,0,0,0,93
2162,104,0,0,0,0,104
2163,1,105,1,1,1,106
2164,0,120,1,1,1,120
2165,5,96,1,1,1,101
2166,0,120,1,1,1,120
2167,100,0,0,0,0,100
2168,0,100,1,1,1,100
2169,120,0,0,0,0,120
2170,5,96,1,1,1,101
2171,5,14,1,1,1,19
2172,0,118,1,1,1,118
2173,0,120,1,1,1,120
2174,1,119,1,1,1,120
2175,0,104,1,1,1,104
2176,0,106,1,1,1,106
2177,1,91,1,1,1,92
2178,4,99,1,1,1,103
2179,0,120,1,1,1,120
2180,0,99,1,1,1,99
2181,120,0,0,0,0,120
2182,6,113,1,1,1,119
2183,120,0,0,0,0,120
2184,111,0,0,0,0,111
2185,1,93,1,1,1,94
2186,3,101,1,1,1,104
2187,118,0,0,0,0,118
2188,0,116,1,1,1,116
2189,75,1,0,0,0,76
2190,1,7,1,1,1,8
2191,120,0,0,0,0,120
2192,120,0,0,0,0,120
2193,1,80,1,1,1,81
2194,105,1,0,0,0,106
2195,0,38,1,1,1,38
2196,120,0,0,0,0,120
2197,0,120,1,1,1,120
2198,120,0,0,0,0,120
2199,0,104,1,1,1,104
2200,0,91,1,1,1,91
2201,119,1,0,0,0,120
2202,3,76,1,1,1,79
2203,93,0,0,0,0,93
2204,120,0,0,0,0,120
2206,120,0,0,0,0,120
2207,72,2,0,0,0,74
2208,2,88,1,1,1,90
2209,0,120,1,1,1,120
2210,102,0,0,0,0,102
2211,120,0,0,0,0,120
2212,0,120,1,1,1,120
2213,115,0,0,0,0,115
2214,0,37,1,1,1,37
2215,5,101,1,1,1,106
2216,120,0,0,0,0,120
2217,96,0,0,0,0,96
2218,120,0,0,0,0,120
2219,0,120,1,1,1,120
2220,119,1,0,0,0,120
2221,1,119,1,1,1,120
2222,7,113,1,1,1,120
2223,0,119,1,1,1,119
2224,0,116,1,1,1,116
2225,0,70,1,1,1,70
2226,120,0,0,0,0,120
2227,0,120,1,1,1,120
2228,2,17,1,1,1,19
2229,0,120,1,1,1,120
2230,0,120,1,1,1,120
2231,0,120,1,1,1,120
2232,52,0,0,0,0,52
2233,114,0,0,0,0,114
2234,1,110,1,1,1,111
2235,0,105,1,1,1,105
2236,118,0,0,0,0,118
2237,0,114,1,1,1,114
2238,1,87,1,1,1,88
2239,119,0,0,0,0,119
2240,0,120,1,1,1,120
2241,0,120,1,1,1,120
2242,3,107,1,1,1,110
2243,0,117,1,1,1,117
2244,120,0,0,0,0,120
2245,4,116,1,1,1,120
2246,1,119,1,1,1,120
2247,4,105,1,1,1,109
2248,102,0,0,0,0,102
2249,119,0,0,0,0,119
2250,108,0,0,0,0,108
2251,120,0,0,0,0,120
2252,120,0,0,0,0,120
2253,106,2,0,0,0,108
2254,0,92,1,1,1,92
2255,2,117,1,1,1,119
2256,0,120,1,1,1,120
2257,120,0,0,0,0,120
2258,6,83,1,1,1,89
2259,116,4,0,0,0,120
2260,3,117,1,1,1,120
2261,120,0,0,0,0,120
2262,118,1,0,0,0,119
2263,114,6,0,0,0,120
2264,0,112,1,1,1,112
2265,0,120,1,1,1,120
2266,120,0,0,0,0,120
2267,107,1,0,0,0,108
2268,92,2,0,0,0,94
2269,118,0,0,0,0,118
2270,4,105,1,1,1,109
2271,1,117,1,1,1,118
2272,120,0,0,0,0,120
2273,0,105,1,1,1,105
2274,0,113,1,1,1,113
2275,2,118,1,1,1,120
2276,0,120,1,1,1,120
2277,0,106,1,1,1,106
2278,75,0,0,0,0,75
2279,5,96,1,1,1,101
2280,0,120,1,1,1,120
2281,1,105,1,1,1,106
2282,0,107,1,1,1,107
2283,0,120,1,1,1,120
2284,116,4,0,0,0,120
2285,0,120,1,1,1,120
2286,0,120,1,1,1,120
2287,119,1,0,0,0,120
2288,119,0,0,0,0,119
2289,0,107,1,1,1,107
2290,104,1,0,0,0,105
2291,0,117,1,1,1,117
2292,114,0,0,0,0,114
2293,120,0,0,0,0,120
2294,29,0,0,0,0,29
2295,1,93,1,1,1,94
2296,1,111,1,1,1,112
2297,118,2,0,0,0,120
2298,0,120,1,1,1,120
2299,106,12,0,0,0,118
2300,117,0,0,0,0,117
2301,120,0,0,0,0,120
2302,120,0,0,0,0,120
2303,0,23,1,1,1,23
2304,2,116,1,1,1,118
2305,120,0,0,0,0,120
2306,119,1,0,0,0,120
2307,120,0,0,0,0,120
2308,2,63,1,1,1,65
2309,120,0,0,0,0,120
2310,118,0,0,0,0,118
2311,0,115,1,1,1,115
2312,120,0,0,0,0,120
2313,119,1,0,0,0,120
2314,85,0,0,0,0,85
2315,0,115,1,1,1,115
2316,0,107,1,1,1,107
2317,120,0,0,0,0,120
2318,0,120,1,1,1,120
2319,5,115,1,1,1,120
2320,91,0,0,0,0,91
2321,0,102,1,1,1,102
2322,114,0,0,0,0,114
2323,0,104,1,1,1,104
2324,0,113,1,1,1,113
2325,112,8,0,0,0,120
2326,2,118,1,1,1,120
2327,116,0,0,0,0,116
2328,0,120,1,1,1,120
2329,0,97,1,1,1,97
2330,115,0,0,0,0,115
2331,0,120,1,1,1,120
2332,0,116,1,1,1,116
2333,2,104,1,1,1,106
2334,0,120,1,1,1,120
2335,0,105,1,1,1,105
2336,120,0,0,0,0,120
2337,1,119,1,1,1,120
2338,120,0,0,0,0,120
2339,120,0,0,0,0,120
2340,112,0,0,0,0,112
2341,0,120,1,1,1,120
2342,0,108,1,1,1,108
2343,2,62,1,1,1,64
2344,111,0,0,0,0,111
2345,120,0,0,0,0,120
2346,120,0,0,0,0,120
2347,0,115,1,1,1,115
2348,79,1,0,0,0,80
2349,0,120,1,1,1,120
2350,112,0,0,0,0,112
2351,0,120,1,1,1,120
2352,0,105,1,1,1,105
2353,0,120,1,1,1,120
2354,0,120,1,1,1,120
2355,120,0,0,0,0,120
2356,108,0,0,0,0,108
2357,115,5,0,0,0,120
2358,120,0,0,0,0,120
2359,0,115,1,1,1,115
2360,0,95,1,1,1,95
2361,0,100,1,1,1,100
2362,107,0,0,0,0,107
2363,13,59,1,1,1,72
2364,1,104,1,1,1,105
2365,0,120,1,1,1,120
2366,114,6,0,0,0,120
2367,113,6,0,0,0,119
2368,103,0,0,0,0,103
2369,0,56,1,1,1,56
2370,79,0,0,0,0,79
2371,120,0,0,0,0,120
2372,120,0,0,0,0,120
2373,1,102,1,1,1,103
2374,0,119,1,1,1,119
2375,10,102,1,1,1,112
2376,1,54,1,1,1,55
2377,0,85,1,1,1,85
2378,0,120,1,1,1,120
2379,0,120,1,1,1,120
2380,73,4,0,0,0,77
2381,120,0,0,0,0,120
2382,120,0,0,0,0,120
2383,120,0,0,0,0,120
2384,0,107,1,1,1,107
2385,0,120,1,1,1,120
2386,120,0,0,0,0,120
2387,0,120,1,1,1,120
2388,120,0,0,0,0,120
2389,0,102,1,1,1,102
2390,110,5,0,0,0,115
